NO assets/teste.xpm
SO assets/teste2.xpm
WE assets/teste3.xpm
EA assets/teste4.xpm
F 220,100,0
C 225,30,0

111111111                  
1001  101                  
1001  1N1                  
1001  111                  
111111111                 
111111111                  