NO ./path_to_the_north_texture
SO ./path_to_the_south_texture



F 0,255,0

WE ./path_to_the_west_texture
EA ./path_to_the_east_texture

C 225,0,0



        1111111111111111111111111
        1000000000110000000000001
        1011000001110001000000001
        1001000000000000000000001
111111111011000001110000000000001
100000000011111111111111111111111
11110111111111111111110010001
11110000000              0001
11000000111  1111     0010001
100000000001 101     10010001
1000000000         1110010001
11000001110101011111011110N0111
11110111 1110101 101111010001
11111111 1111111 111111111111
