NO ./path_to_the_north_texture
SO ./path_to_the_south_texture



F 0,255,0

WE ./path_to_the_west_texture
EA ./path_to_the_east_texture

C 225,0,0



        1111111111111111111111111
        1000000000110000000000001
        1011000001110001000000001
        1001000000000000000000001
111111111011000001110000000000001
100000000011111111111111111111111
11110111111111111111111110001
11110000001             10001
11000000111  1111    11110001
100000000011 111     100100011
10000000011         1110010001
11000011111111111111111110N0111
11110111 1110101 101111010001
11111111 1111111 111111111111
